11111111111111111
10111111111111111
10000000000100001
10000000000100001
10100000000100001
10100001000001001
10100001000001001
10100801111111111
11111111111111111
